台湾=TaiWan
上海=ShangHai
香港=XiangGang
北京=BeiJing
河南=HeNan
福建=FuJian
广东=GuangDong
青海=QingHai
辽宁=LiaoNing
广西=GuangXi
浙江=ZheJiang
江苏=JiangSu
云南=YunNan
四川=SiChuan
湖北=HuBei
吉林=JiLin
陕西=Shan'Xi
黑龙江=HeiLongJiang
山东=ShanDong
河北=HeBei
天津=TianJin
内蒙古=NeiMengGu
湖南=HuNan
江西=JiangXi
安徽=AnHui
新疆=XinJiang
重庆=ChongQing
甘肃=GanSu
山西=ShanXi
海南=HaiNan
贵州=GuiZhou
宁夏=NingXia
澳门=AoMen
西藏=XiZang