台湾=TAI WAN
上海=SHANG HAI
香港=XIANG GANG
北京=BEI JING
河南=HE NAN
福建=FU JIAN
广东=GUANG DONG
青海=QING HAI
辽宁=LIAO NING
广西=GUANG XI
浙江=ZHE JIANG
江苏=JIANG SU
云南=YUN NAN
四川=SI CHUAN
湖北=HU BEI
吉林=JI LIN
陕西=SHAN' XI
黑龙江=HEI LONG JIANG
山东=SHAN DONG
河北=HE BEI
天津=TIAN JIN
内蒙古=NEI MENG GU
湖南=HU NAN
江西=JIANG XI
安徽=AN HUI
新疆=XIN JIANG
重庆=CHONG QING
甘肃=GAN SU
山西=SHAN XI
海南=HAI NAN
贵州=GUI ZHOU
宁夏=NING XI
澳门=AO MEN
西藏=XI ZANG